8
0 0
2 0
2 6
8 6
8 4
14 4
14 10
19 10
10
5 0 0 0 0 0
7 0 0 0 1 0 0 4
7 0 0 0 1 1 4 4
6 0 0 0 1 2 0
8 0 0 0 4 0 1 1 2
9 0 0 0 1 0 4 1 0 0
10 0 0 1 0 0 0 1 2 0 0
12 4 4 4 4 4 4 4 4 4 4 4 4
9 0 1 1 2 2 1 0 1 0
2 1 3
